....................
###############.....
....................
........############
....................
##############......
....................
.......#############
....................