..........#...
.##....#.###..
..##...##.....
..........#...
..##...#......
#.###..#.###..
....##........
.........#####
.##.......#...
..##....#.....
.......#.###..
..##.....##...
#.###..#......
....##...##...
.......#......
.##......##...
..##...#.#####
.......##.....
..##......#...
#.###..#......
....##........