....###.....#.......
....#.......#...#...
....#...........#...
..###........####...
..........#..#....##
..........#.........
..........########..
#####............###
.........###........
########...#........
.......#...#........
.......#........##..
.......#............
.......########.....
..............#.....
####..........#.....
...#......#####.....
...#................
...#####.......#####
....................